1,1,1,1,1,1,1,1
1,1,1,c,1,1,1,1
1,1,1, ,1,1,1,1
1,1,1,b, ,b,c,1
1,c, ,b,p,1,1,1
1,1,1,1,b,1,1,1
1,1,1,1,c,1,1,1
1,1,1,1,1,1,1,1