1,1,1,1,1,1,1,1,1
1, , , ,1,1,1,1,1
1, ,b,p,1,1,1,1,1
1, ,b,b,1,1,1,c,1
1,1,1, ,1,1,1,c,1
1,1,1, , , , ,c,1
1,1, , , ,1, , ,1
1,1, , , ,1,1,1,1
1,1,1,1,1,1,1,1,1
