1,1,1,1,1,1,1,1
1,1,1, , , , ,1
1,1,1,b,b,b, ,1
1,p, ,b,c,c, ,1
1, ,b,c,c,c,1,1
1,1,1,1, , ,1,1
1,1,1,1,1,1,1,1