1,1,1,1,1,1,1,1
1,1,1, , ,p,1,1
1, , ,b,c, ,1,1
1, , ,c,b,c, ,1
1,1,1, , ,b, ,1
1,1,1, , , ,1,1
1,1,1,1,1,1,1,1