1,1,1,1,1,1,1,1,1
1, , , , ,1,1,1,1
1,p,b,b,b,1,1,1,1
1, , ,1,c,c,1,1,1
1,1, , ,c,c,b, ,1
1,1, , , , , , ,1
1,1,1,1,1,1,1,1,1