1,1,1,1,1,1,1
1,c, ,c, ,1,1
1,b,p,b,b, ,1
1, , , ,1, ,1
1, , ,c, , ,1
1,1,1,1,1,1,1