1,1,1,1,1,1,1
1, , , ,1,1,1
1,b,1, ,1,1,1
1,c,c,b, , ,1
1, ,p,1,b, ,1
1, , , , ,c,1
1,1,1,1,1,1,1