1,1,1,1,1,1,1,1
1, , , , ,1,1,1
1, , , ,c,c, ,1
1, ,b,b,b,p, ,1
1, , ,1, ,c, ,1
1,1,1,1,1,1,1,1