1,1,1,1,1,1,1,1,1
1,1,1, , ,1,1,1,1
1,1,1, ,b,1,1,1,1
1, ,p,b,c, ,b, ,1
1, , ,c,b, , , ,1
1,1,1, , ,1,1,1,1
1,1,1, , ,1,1,1,1
1,1,1,1,1,1,1,1,1