1,1,1,1,1,1,1,1
1, , ,1, , , ,1
1, ,b,c,c,b, ,1
1,p,b,c,b, ,1,1
1, ,b,c,c,b, ,1
1, , ,1, , , ,1
1,1,1,1,1,1,1,1