1,1,1,1,1,1,1,1,1,1
1,1,1,1,1,1, , , ,1
1, ,b, ,c,c, ,b, ,1
1,p,b,b,c,c, ,b,1,1
1, ,b, ,c,c, , ,1,1
1,1,1,1,1,1,1,1,1,1