1,1,1,1,1,1,1
1,1,1, , , ,1
1,c, ,c,1, ,1
1, ,b,b, , ,1
1,p,b,c, ,1,1
1,1,1,1,1,1,1