1,1,1,1,1,1,1
1,c, ,c, ,c,1
1, ,b,b,b, ,1
1,c,b,p,b,c,1
1, ,b,b,b, ,1
1,c, ,c, ,c,1
1,1,1,1,1,1,1