1,1,1,1,1,1,1,1
1,1, , , ,1,1,1
1,1,b,1, ,1,1,1
1, , ,c,b, ,p,1
1, ,1, , ,1, ,1
1, ,1,c,c,b, ,1
1, , , ,1,1,1,1
1,1,1,1,1,1,1,1