1,1,1,1,1,1,1,1,1
1,1, , , ,1,1,1,1
1, ,c, ,c, ,c,1,1
1, ,1, ,1,1, ,1,1
1, , , , ,b,b,p,1
1,1,1, ,1, ,b, ,1
1,1,1, , , ,1,1,1
1,1,1,1,1,1,1,1,1