1,1,1,1,1,1,1,1,1
1,1,1,1,1, , ,1,1
1,1, ,b, , , ,1,1
1, , ,1, ,1,b,1,1
1,c,p,c, , , ,1,1
1,1, ,1, ,1, , ,1
1,1, , , , , , ,1
1,1, , ,1,1,1,1,1
1,1,1,1,1,1,1,1,1