1,1,1,1,1,1,1,1,1
1,1,1,1,1, , ,1,1
1,1, ,b, , , ,1,1
1, , ,1, ,1,b,1,1
1,c,p,c,c, , ,1,1
1,1, ,1, ,1, , ,1
1,1, , , ,b, , ,1
1,1, , ,1,1,1,1,1
1,1,1,1,1,1,1,1,1