1,1,1,1,1,1,1,1
1, , ,1,1,1,1,1
1, , , , , ,1,1
1, , , , , ,1,1
1,1,1, ,1,1,1,1
1, ,b,b, , ,1,1
1, ,c, ,c,p, ,1
1,1,1,1, , , ,1
1,1,1,1,1,1,1,1