1,1,1,1,1,1,1,1
1, , ,1,1,1,1,1
1, , , , , ,1,1
1, , , , , ,1,1
1,1,1, ,1,1,1,1
1, ,b,b,b, ,1,1
1, ,c,c,c,p, ,1
1,1,1,1, , , ,1
1,1,1,1,1,1,1,1