1,1,1,1,1,1
1,1, , , ,1
1, ,p,b,1,1
1,1,b, ,1,1
1,1, ,b, ,1
1,c,b, , ,1
1,c,c, , ,1
1,1,1,1,1,1