1,1,1,1,1,1,1,1,1
1, , , ,1,1,1,1,1
1, ,b, ,1, , , ,1
1, , , ,1,b,1, ,1
1,1,1,b, , , , ,1
1,1, , , ,1,1,1,1
1,1, ,p,c,c,c,1,1
1,1,1,1,1,1,1,1,1