1,1,1,1,1,1
1, ,1, ,c,1
1, ,b, ,c,1
1, ,p,b,c,1
1, ,b,b,c,1
1, , ,1,1,1
1,1,1,1,1,1